R 1920 1080
WE                  ./textures/trak_weaponspawn_red.xpm
NO ./textures/trak_weaponspawn_blue.xpm
F 64,63,63
C 122,20,14

SO ./textures/trak_weaponspawn_green.xpm
EA ./textures/trak_weaponspawn_yellow.xpm
S ./sprites/cage5.xpm

11111111111111111111111111111111111111
10000010000000000000010000000000000001
100S0010000000000000010000001111110001
10000010000000000000010001110000010201
10000010000001210000000000000000011111
10000000000001110000000000000000000001
10000000000001210000000000000002000001
10000000000000000000000000000000000001
10000001111100000000010000000111100001
10000000000000000000010000000111100001
10000000211200000000010000000000000001
10000000122100000000011111000000000111
10000000200200000000000000000000000111
10010100100100000111110000000000000111
10010100200200000000010000000000000001
11110100100100000000010000000000000001
10110111200211111111111111111111111111
10110100000000000000000000000001002001
10000001100000000011101110000000000001
11111111111111111111111111111111111111
